XXXXXXXSXXXXXXX
X...X...X...X.X
X.X.X.X.X.X...X
X.X.X.....X.X.X
X.X.X.X.X...X.X
X.X.X.X.XXXXXXX
XXXXX.........X
X....X.X......X
X.XXXX........X
X.X.X.........X
X.X.X.........X
X.XXX.........X
X.............X
X.............X
XXXXXXXGXXXXXXX